111111111111111111111
101110000010011000101
110P110CCC010C010C001
11101CC11000101011101
1100000C0C000C000C001
11100C011E00101011101
1100000C0C000C000C001
1100000C0C000C000C001
1000C00C0000CCC0C0001
111111111111111111111